PinardeChamartin	Manoteras
Manoteras	Hortaleza
Hortaleza	ParquedeSantaMaría
ParquedeSantaMaría	SanLorenzo
SanLorenzo	MardeCristal
MardeCristal	Canillas
Canillas	Esperanza
Esperanza	ArturoSoria
ArturoSoria	AvenidadelaPaz
AvenidadelaPaz	AlfonsoXIII
AlfonsoXIII	Prosperidad
Prosperidad	AvenidadeAmérica
AvenidadeAmérica	DiegodeLeón
DiegodeLeón	Lista
Lista	Goya
Goya	Velázquez
Velázquez	Serrano
Serrano	Colón
Colón	AlonsoMartínez
AlonsoMartínez	Bilbao
Bilbao	SanBernardo
SanBernardo	Argüelles
