WestRuislip	RuislipGardens
RuislipGardens	SouthRuislip
SouthRuislip	Northolt
Northolt	Greenford
Greenford	Perivale
Perivale	HangerLane
HangerLane	NorthActon
EalingBroadway	WestActon
WestActon	NorthActon
NorthActon	EastActon
EastActon	WhiteCity
WhiteCity	Shepherd'sBush
Shepherd'sBush	HollandPark
HollandPark	NottingHillGate
NottingHillGate	Queensway
Queensway	LancasterGate
LancasterGate	MarbleArch
MarbleArch	BondStreet
BondStreet	OxfordCircus
OxfordCircus	TottenhamCourtRoad
TottenhamCourtRoad	Holborn
Holborn	ChanceryLane
ChanceryLane	St.Paul's
St.Paul's	Bank
Bank	LiverpoolStreet
LiverpoolStreet	BethnalGreen
BethnalGreen	MileEnd
MileEnd	Stratford
Stratford	Leyton
Leyton	LeytonStone
LeytonStone	Snaresbrook
Snaresbrook	SouthWoodford
SouthWoodford	Woodford
LeytonStone	Wanstead
Wanstead	Redbridge
Redbridge	GantsHill
GantsHill	NewburyPark
NewburyPark	Barkingside
Barkingside	Fairlop
Fairlop	Hainault
Hainault	GrangeHill
GrangeHill	Chigwell
Chigwell	RodingValley
RodingValley	Woodford
Woodford	BuckhurstHill
BuckhurstHill	Loughton
Loughton	Debden
Debden	TheydonBois
TheydonBois	Epping
