Chesham	ChalfontandLatimer
Amersham	ChalfontandLatimer
ChalfontandLatimer	Chorleywood
Chorleywood	Rickmansworth
Rickmansworth	MoorPark
Watford	Croxley
Croxley	MoorPark
MoorPark	Northwood
Northwood	NorthwoodHills
NorthwoodHills	Pinner
Pinner	NorthHarrow
NorthHarrow	HarrowOnTheHill
Uxbridge	Hillingdon
Hillingdon	Ickenham
Ickenham	Ruislip
Ruislip	RuislipManor
RuislipManor	Eastcote
Eastcote	RaynersLane
RaynersLane	WestHarrow
WestHarrow	HarrowOnTheHill
HarrowOnTheHill	NorthwickPark
NorthwickPark	PrestonRoad
PrestonRoad	WembleyPark
WembleyPark	FinchleyRoad
FinchleyRoad	BakerStreet
BakerStreet	GreatPortlandStreet
GreatPortlandStreet	EustonSquare
EustonSquare	King'sCrossSt.Pancras
King'sCrossSt.Pancras	Farringdon
Farringdon	Barbican
Barbican	Moorgate
Moorgate	LiverpoolStreet
LiverpoolStreet	Aldgate
