Uxbridge	Hillingdon
Hillingdon	Ickenham
Ickenham	Ruislip
Ruislip	RuislipManor
RuislipManor	Eastcote
Eastcote	RaynersLane
RaynersLane	SouthHarrow
SouthHarrow	SudburyHill
SudburyHill	SudburyTown
SudburyTown	Alperton
Alperton	ParkRoyal
ParkRoyal	NorthEaling
NorthEaling	EalingCommon
EalingCommon	ActonTown
HeathrowTerminal123	HattonCross
HattonCross	HeathrowTerminal4
HeathrowTerminal4	HeathrowTerminal123
HeathrowTerminal5	HeathrowTerminal123
HattonCross	HounslowWest
HounslowWest	HounslowCentral
HounslowCentral	HounslowEast
HounslowEast	Osterley
Osterley	BostonManor
BostonManor	Northfields
Northfields	SouthEaling
SouthEaling	ActonTown
ActonTown	TurnhamGreen
TurnhamGreen	Hammersmith
Hammersmith	BaronsCourt
BaronsCourt	Earl'sCourt
Earl'sCourt	GloucesterRoad
GloucesterRoad	SouthKensington
SouthKensington	Knightsbridge
Knightsbridge	HydeParkCorner
HydeParkCorner	GreenPark
GreenPark	PiccadillyCircus
PiccadillyCircus	LeicesterSquare
LeicesterSquare	CoventGarden
CoventGarden	Holborn
Holborn	RussellSquare
RussellSquare	King'sCrossSt.Pancras
King'sCrossSt.Pancras	CaledonianRoad
CaledonianRoad	HollowayRoad
HollowayRoad	Arsenal
Arsenal	FinsburyPark
FinsburyPark	ManorHouse
ManorHouse	TurnpikeLane
TurnpikeLane	WoodGreen
WoodGreen	BoundsGreen
BoundsGreen	ArnosGrove
ArnosGrove	Southgate
Southgate	Oakwood
Oakwood	Cockfosters
